11111111111111111111
1P001C000C0001000001
11001110011011101111
1000C100110C00100001
100011111100110111011
100000000000001C0001
11111111111111111111
100C000C000C00010001
11111111111111111111
100000000000001C00011
10001111110011011101
1000C100110C00100001
11001110011011101111
1P001C000C000100E001
11111111111111111111
