1111111111111111111111111111111
1P0010001000C0000C0011000C00111
1110111011101111111011110111011
10000000000000000000000000000E1
1110111011101111111011110111001
1C001000100010001000100010001C1
1111111111111111111111111111111