1111111111111111111111111111111111111111111
1P001000010001000100C1000100010001000100011
1110111111101111111011111111111111111111111
1C000000000000000C0000000000000000000000001
1011111111111111111111111111111111111111111
1000100000001000100000001000100000001000001
1C000C001C000C000C001C000C000C001C000C001C1
1111101111111111111111111111111111111111111
10000000000000000000000000000000000000000E1
1111111111111111111111111111111111111111111